F 70,225,0
NO ./Textures/1.png
SO ./Textures/3.png
WE ./Textures/1.png
EA ./Textures/3.png
C 10,30,0

        1111111111111111111111111
        1000000000110000000000001
        1110000011100000000000001
        1001000000000000000000001
111111111011000001100000000000001
100000000011000000110111111101111
111101111111110111000000010001
11110111111111011101010010001 
11000000110101011100000010001
100000000000000001100000010001
10000000000000S000101010010001
110000101010010111110111100111
11110111 1110101 1011110100001
11111111 1111111 111111111111