F 70,225,0
NO ./Textures/1.png
SO ./Textures/3.png
WE ./Textures/1.png
EA ./Textures/3.png
C 10,30,0

        1111111111111111111111111
        1000000000110000000000001
        1011000001110000000000001
        1001000000000000000000001
111111111011000001110000000000001
100000000011000001110111111111111
11110111111111011100000010001
11110111111111011101010010001
11000000110101011100000010001
10000000000000001100000011001

10000000000000001101010000101
11000001110101011111011110N0011
11110111 1110101 101111010001
11111111 1111 11 111111111111