F 70,225,0
NO ./Textures/1.png
SO ./Textures/3.png
WE ./Textures/1.png
EA ./Textures/3.png
C 10,30,0
111111111111111111111111111111111
100000000000000110000000000000001
1000000000000001100D0000000000001
100000000000000N00000000000000001
100000000000000000000000000000001
111111111111111111111111111111111