NO ./Textures/1.png
SO ./Textures/3.png
WE ./Textures/1.png
EA ./Textures/3.png
F 70,225,0
C 10,30,0
        1111111111111111111111111
        1000000000110000000000001
        11100000111000000S0000001
        1001000000000000000000001
111011111011000001110000000000001
100000000011000001110111111101111
11110111111111011100000010001
11110111111111011101010010001 
11000000110101011100000010001
10000000000000001100000010001
10000000000000000101010010001
11000010101010111110111100111
11110111 1110101 1011110100001
11111111 1111111 111111111111