F 70,225,0
NO ./Textures/yahay.png
SO ./Textures/alahoma.png
WE ./Textures/ljkkjkk.png
EA ./Textures/hassbiyalahwanama.png
C 10,30,0

111111111111111111111111111111111
100000000000000110000000000000001
100000000000000110000000000000001                                                          
100000000000000N00000000000000001
100000000000000000000000000000001
111111111111111111111111111111111
