NO ./Textures/two.png
SO ./Textures/one.png
WE ./Textures/two.png
EA ./Textures/one.png
C 64,162,216
F 100,56,97
1111111111111111111111111
1000000000000000000000001
1000000000000000000000001
1000000000000000000000001
1000000000000100000000001
1000000000N01000000000001
1000000000000000000000001
1000000000000000000000001
1000000000000000000000001
1000000000000000000000001
1111111111111111111111111
