NO ./Textures/22.png
SO ./Textures/22.png
WE ./Textures/22.png
EA ./Textures/22.png
C 64,162,216
F 100,56,97
1111111111111111111111111
1000000000000000000000001
1000000000000000000000001
1000000000000000000000001
1000000000000000000000001
1000000000N00000000000001
1000000000000000000000001
1000000000000000000000001
1000000000000000000000001
1000000000000000000000001
1111111111111111111111111
