NO ./Textures/one.png
SO ./Textures/two.png
WE ./Textures/one.png
EA ./Textures/two.png
F 200,200,0
C 251,30,0
1111111111111111111111111
1000000000000000000000001
1000000000000000000000001
1000000000N00000000000001
1000000000000000000000001
1000000001000000000000001
1000000000100000000000001
1000000000000000000000001
1000000000000000000000001
1000000000000000000000001
1111111111111111111111111
