F  100,56,97
NO ./Textures/yahay.png
SO ./Textures/alahoma.png
WE ./Textures/ljkkjkk.png
EA ./Textures/hassbiyalahwanama.png
C  64,162,216
11111111111111111111111111
1000000000001000000000001
1000000000001000000000001
100000000000100000000001
1000000000011000W00000011
10000000000001000000000001
1000000000001000000000001
100000000000D000000000001
1000000000001000000000001
1000000001001000000010001
111111111111111111111111