NO ./Textures/yafatah.png
SO ./Textures/alah.png
WE ./Textures/yarbi.png
EA ./Textures/yakarim.png
C 64,162,216
F 100,56,97


1111111111111111111111111
1000000000001000000000001
1000000000001000000000001
1000000000001000000000001
1000000000001100000000001
1000000000N01000000000001
1000000000001000000000001
100000000000D000000000001
1000000000001000000000001
1000000000001000000000001
1111111111111111111111111
